1,2,0,3 1,2,0,3 1,2,0,3 1,2,0,3 0,2,0,7 0,2,0,7 0,2,0,7 0,2,0,7 1,2,0,3 1,2,0,3 1,2,0,3 1,2,0,3
1,2,0,3 1,2,0,3 1,2,0,3 1,2,0,3 1,2,0,3 1,2,0,3 1,2,0,3 1,2,0,3 1,2,0,3 1,2,0,3 1,2,0,3 1,2,0,3
1,2,0,3 1,2,0,3 1,2,0,3 1,2,0,3 1,2,0,3 1,2,0,3 1,2,0,3 1,2,0,3 1,2,0,3 1,2,0,3 1,2,0,3 1,2,0,3
1,2,0,3 1,2,0,3 1,2,0,3 1,2,0,3 1,2,0,3 1,2,0,3 1,2,0,3 1,2,0,3 1,2,0,3 1,2,0,3 1,2,0,3 1,2,0,3
1,2,0,3 1,2,0,3 1,2,0,3 1,2,0,3 1,2,0,3 1,2,0,3 1,2,0,3 1,2,0,3 1,2,0,3 1,2,0,3 7,2,0,3 1,2,0,3
1,2,0,3 1,2,0,3 7,2,0,3 1,2,0,3 1,2,0,3 1,2,0,3 1,2,0,3 1,2,0,3 1,2,0,3 1,2,0,3 1,2,0,3 1,2,0,3
1,2,0,3 1,2,0,3 1,2,0,3 1,2,0,3 1,2,0,3 1,2,0,3 1,2,0,3 7,2,0,3 1,2,0,3 1,2,0,3 1,2,0,3 1,2,0,3
1,2,0,3 1,2,0,3 1,2,0,3 1,2,0,3 7,2,0,3 1,2,0,3 1,2,0,3 1,2,0,3 1,2,0,3 1,2,0,3 1,2,0,3 1,2,0,3
1,2,0,3 1,2,0,3 1,2,0,3 1,2,0,3 1,2,0,3 1,2,0,3 1,2,0,3 1,2,0,3 1,2,0,3 1,2,0,3 1,2,0,3 1,2,0,3
1,2,0,3 1,2,0,3 1,2,0,3 1,2,0,3 1,2,0,3 1,2,0,3 1,2,0,3 1,2,0,3 1,2,0,3 7,2,2,3 1,2,0,3 1,2,0,3
1,2,0,3 1,2,0,3 1,2,0,3 1,2,0,3 1,2,0,3 1,2,0,3 1,2,0,3 1,2,0,3 1,2,0,3 1,2,0,3 1,2,0,3 1,2,0,3
1,2,0,3 1,2,0,3 1,2,0,3 1,2,0,3 2,2,0,0 2,2,0,0 2,2,0,0 2,2,0,0 1,2,0,3 1,2,0,3 1,2,0,3 1,2,0,3
1,2,0,3 1,2,0,3 1,2,0,3 1,2,0,3 2,2,0,0 0,2,0,7 0,2,0,7 2,2,0,0 1,2,0,3 1,2,0,3 1,2,0,3 1,2,0,3
7,2,0,3 1,2,0,3 1,2,0,3 1,2,0,3 2,2,0,0 0,2,0,7 0,2,0,7 2,2,0,0 1,2,0,3 1,2,0,3 1,2,0,3 1,2,0,3
1,2,0,3 1,2,0,3 1,2,0,3 1,2,0,3 2,2,0,0 2,2,0,0 2,2,0,0 2,2,0,0 1,2,0,3 1,2,0,3 1,2,0,3 1,2,0,3
1,2,0,3 1,2,0,3 1,2,0,3 1,2,0,3 1,2,0,3 6,N,1,3 6,N,1,3 1,2,0,3 1,2,0,3 1,2,0,3 1,2,0,3 1,2,0,3
1,2,0,3 1,2,0,3 1,2,0,3 1,2,0,3 1,2,0,3 1,2,0,3 1,2,0,3 1,2,0,3 1,2,0,3 1,2,0,3 7,2,0,3 1,2,0,3
1,2,0,3 1,2,0,3 1,2,0,3 1,2,0,3 1,2,0,3 1,2,0,3 1,2,0,3 1,2,0,3 1,2,0,3 1,2,0,3 1,2,0,3 1,2,0,3
1,2,0,3 1,2,0,3 1,2,0,3 1,2,0,3 1,2,0,3 1,2,0,3 1,2,0,3 1,2,0,3 1,2,0,3 1,2,0,3 1,2,0,3 1,2,0,3
1,2,0,3 1,2,0,3 1,2,0,3 1,2,0,3 1,2,0,3 1,2,0,3 1,2,0,3 1,2,0,3 1,2,0,3 1,2,0,3 1,2,0,3 1,2,0,3
1,2,0,3 1,2,0,3 1,2,0,3 1,2,0,3 1,2,0,3 1,2,0,3 1,2,0,3 1,2,0,3 1,2,0,3 1,2,0,3 1,2,0,3 1,2,0,3
1,2,0,3 1,2,0,3 1,2,0,3 1,2,0,3 1,2,0,3 1,2,0,3 1,2,0,3 1,2,0,3 1,2,0,3 1,2,0,3 1,2,0,3 1,2,0,3
1,2,0,3 7,2,0,3 1,2,0,3 1,2,0,3 1,2,0,3 1,2,0,3 1,2,0,3 1,2,0,3 1,2,0,3 1,2,0,3 7,2,0,3 1,2,0,3
1,2,0,3 1,2,0,3 1,2,0,3 1,2,0,3 1,2,0,3 1,2,0,3 1,2,0,3 1,2,0,3 1,2,0,3 1,2,0,3 1,2,0,3 1,2,0,3
1,2,0,3 1,2,0,3 1,2,0,3 1,2,0,3 1,2,0,3 1,2,0,3 7,2,0,3 1,2,0,3 1,2,0,3 1,2,0,3 1,2,0,3 1,2,0,3
1,2,0,3 1,2,0,3 1,2,0,3 7,2,0,3 1,2,0,3 1,2,0,3 1,2,0,3 1,2,0,3 1,2,0,3 1,2,0,3 1,2,0,3 1,2,0,3
1,2,0,3 1,2,0,3 1,2,0,3 1,2,0,3 0,2,0,7 0,2,0,7 0,2,0,7 0,2,0,7 1,2,0,3 1,2,0,3 1,2,0,3 1,2,0,3