1,2,0,3,0 1,2,0,3,0 1,2,0,3,0 1,2,0,3,0 0,2,0,7,0 0,2,0,7,0 0,2,0,7,0 0,2,0,7,0 1,2,0,3,0 1,2,0,3,0 1,2,0,3,0 1,2,0,3,0
1,2,0,3,0 1,2,0,3,0 1,2,0,3,0 1,2,0,3,0 1,2,0,3,0 1,2,0,3,0 1,2,0,3,0 1,2,0,3,0 1,2,0,3,0 1,2,0,3,0 1,2,0,3,0 1,2,0,3,0
1,2,0,3,0 1,2,0,3,0 1,2,0,3,0 1,2,0,3,0 1,2,0,3,0 1,2,0,3,0 1,2,0,3,0 1,2,0,3,0 1,2,0,3,0 1,2,0,3,0 1,2,0,3,0 1,2,0,3,0
1,2,0,3,0 1,2,0,3,0 1,2,0,3,0 1,2,0,3,0 1,2,0,3,0 1,2,0,3,0 1,2,0,3,0 1,2,0,3,0 1,2,0,3,0 1,2,0,3,0 1,2,0,3,0 1,2,0,3,0
1,2,0,3,0 1,2,0,3,0 1,2,0,3,0 1,2,0,3,0 1,2,0,3,0 1,2,0,3,0 1,2,0,3,0 1,2,0,3,0 1,2,0,3,0 1,2,0,3,0 7,2,0,3,2 1,2,0,3,0
1,2,0,3,0 1,2,0,3,0 7,2,0,3,2 1,2,0,3,0 1,2,0,3,0 1,2,0,3,0 1,2,0,3,0 1,2,0,3,0 1,2,0,3,0 1,2,0,3,0 1,2,0,3,0 1,2,0,3,0
1,2,0,3,0 1,2,0,3,0 1,2,0,3,0 1,2,0,3,0 1,2,0,3,0 1,2,0,3,0 1,2,0,3,0 7,2,0,3,2 1,2,0,3,0 1,2,0,3,0 1,2,0,3,0 1,2,0,3,0
1,2,0,3,0 1,2,0,3,0 1,2,0,3,0 1,2,0,3,0 7,2,0,3,2 1,2,0,3,0 1,2,0,3,0 1,2,0,3,0 1,2,0,3,0 1,2,0,3,0 1,2,0,3,0 1,2,0,3,0
1,2,0,3,0 1,2,0,3,0 1,2,0,3,0 1,2,0,3,0 1,2,0,3,0 1,2,0,3,0 1,2,0,3,0 1,2,0,3,0 1,2,0,3,0 1,2,0,3,0 1,2,0,3,0 1,2,0,3,0
1,2,0,3,0 1,2,0,3,0 1,2,0,3,0 1,2,0,3,0 1,2,0,3,0 1,2,0,3,0 1,2,0,3,0 1,2,0,3,0 1,2,0,3,0 7,2,2,3,2 1,2,0,3,0 1,2,0,3,0
1,2,0,3,0 1,2,0,3,0 1,2,0,3,0 1,2,0,3,0 1,2,0,3,0 1,2,0,3,0 1,2,0,3,0 1,2,0,3,0 1,2,0,3,0 1,2,0,3,0 1,2,0,3,0 1,2,0,3,0
1,2,0,3,0 1,2,0,3,0 1,2,0,3,0 1,2,0,3,0 2,2,0,0,0 2,2,0,0,0 2,2,0,0,0 2,2,0,0,0 1,2,0,3,0 1,2,0,3,0 1,2,0,3,0 1,2,0,3,0
1,2,0,3,0 1,2,0,3,0 1,2,0,3,0 1,2,0,3,0 2,2,0,0,0 0,2,0,7,0 0,2,0,7,0 2,2,0,0,0 1,2,0,3,0 1,2,0,3,0 1,2,0,3,0 1,2,0,3,0
7,2,0,3,2 1,2,0,3,0 1,2,0,3,0 1,2,0,3,0 2,2,0,0,0 0,2,0,7,0 0,2,0,7,0 2,2,0,0,0 1,2,0,3,0 1,2,0,3,0 1,2,0,3,0 1,2,0,3,0
1,2,0,3,0 1,2,0,3,0 1,2,0,3,0 1,2,0,3,0 2,2,0,0,0 2,2,0,0,0 2,2,0,0,0 2,2,0,0,0 1,2,0,3,0 1,2,0,3,0 1,2,0,3,0 1,2,0,3,0
1,2,0,3,0 1,2,0,3,0 1,2,0,3,0 1,2,0,3,0 1,2,0,3,0 6,N,1,3,2 6,N,1,3,2 1,2,0,3,0 1,2,0,3,0 1,2,0,3,0 1,2,0,3,0 1,2,0,3,0
1,2,0,3,0 1,2,0,3,0 1,2,0,3,0 1,2,0,3,0 1,2,0,3,0 1,2,0,3,0 1,2,0,3,0 1,2,0,3,0 1,2,0,3,0 1,2,0,3,0 7,2,0,3,2 1,2,0,3,0
1,2,0,3,0 1,2,0,3,0 1,2,0,3,0 1,2,0,3,0 1,2,0,3,0 1,2,0,3,0 1,2,0,3,0 1,2,0,3,0 1,2,0,3,0 1,2,0,3,0 1,2,0,3,0 1,2,0,3,0
1,2,0,3,0 1,2,0,3,0 1,2,0,3,0 1,2,0,3,0 1,2,0,3,0 1,2,0,3,0 1,2,0,3,0 1,2,0,3,0 1,2,0,3,0 1,2,0,3,0 1,2,0,3,0 1,2,0,3,0
1,2,0,3,0 1,2,0,3,0 1,2,0,3,0 1,2,0,3,0 1,2,0,3,0 1,2,0,3,0 1,2,0,3,0 1,2,0,3,0 1,2,0,3,0 1,2,0,3,0 1,2,0,3,0 1,2,0,3,0
1,2,0,3,0 1,2,0,3,0 1,2,0,3,0 1,2,0,3,0 1,2,0,3,0 1,2,0,3,0 1,2,0,3,0 1,2,0,3,0 1,2,0,3,0 1,2,0,3,0 1,2,0,3,0 1,2,0,3,0
1,2,0,3,0 1,2,0,3,0 1,2,0,3,0 1,2,0,3,0 1,2,0,3,0 1,2,0,3,0 1,2,0,3,0 1,2,0,3,0 1,2,0,3,0 1,2,0,3,0 1,2,0,3,0 1,2,0,3,0
1,2,0,3,0 7,2,0,3,2 1,2,0,3,0 1,2,0,3,0 1,2,0,3,0 1,2,0,3,0 1,2,0,3,0 1,2,0,3,0 1,2,0,3,0 1,2,0,3,0 7,2,0,3,2 1,2,0,3,0
1,2,0,3,0 1,2,0,3,0 1,2,0,3,0 1,2,0,3,0 1,2,0,3,0 1,2,0,3,0 1,2,0,3,0 1,2,0,3,0 1,2,0,3,0 1,2,0,3,0 1,2,0,3,0 1,2,0,3,0
1,2,0,3,0 1,2,0,3,0 1,2,0,3,0 1,2,0,3,0 1,2,0,3,0 1,2,0,3,0 7,2,0,3,2 1,2,0,3,0 1,2,0,3,0 1,2,0,3,0 1,2,0,3,0 1,2,0,3,0
1,2,0,3,0 1,2,0,3,0 1,2,0,3,0 7,2,0,3,2 1,2,0,3,0 1,2,0,3,0 1,2,0,3,0 1,2,0,3,0 1,2,0,3,0 1,2,0,3,0 1,2,0,3,0 1,2,0,3,0
1,2,0,3,0 1,2,0,3,0 1,2,0,3,0 1,2,0,3,0 0,2,0,7,0 0,2,0,7,0 0,2,0,7,0 0,2,0,7,0 1,2,0,3,0 1,2,0,3,0 1,2,0,3,0 1,2,0,3,0