2,2,0,2,0 2,2,0,2,0 2,2,0,2,0 2,2,0,2,0 2,2,0,2,0 1,2,0,3,0 1,2,0,3,0 1,2,0,3,0 2,2,0,2,0 2,2,0,2,0 4,N,2,4,0 2,2,0,2,0 2,2,0,2,0
2,2,0,2,0 3,2,0,2,2 2,2,0,2,0 2,2,0,2,0 2,2,0,2,0 1,2,0,3,0 6,N,3,3,2 1,2,0,3,0 2,2,0,2,0 2,2,0,2,0 4,N,2,4,0 2,2,0,2,0 2,2,0,2,0
2,2,0,2,0 2,2,0,2,0 2,2,0,2,0 2,2,0,2,0 2,2,0,2,0 1,2,0,3,0 1,2,0,3,0 1,2,0,3,0 2,2,0,2,0 2,2,0,2,0 4,N,2,4,0 2,2,0,2,0 3,2,5,2,2
2,2,0,2,0 2,2,0,2,0 3,2,0,2,2 2,2,0,2,0 2,2,0,2,0 1,2,0,3,0 1,2,0,3,0 1,2,0,3,0 2,2,0,2,0 2,2,0,2,0 4,N,2,4,0 2,2,0,2,0 2,2,0,2,0
2,2,0,2,0 2,2,0,2,0 2,2,0,2,0 2,2,0,2,0 2,2,0,2,0 1,2,0,3,0 1,2,0,3,0 1,2,0,3,0 2,2,0,2,0 2,2,0,2,0 4,N,4,4,0 4,N,2,4,0 4,N,2,4,0
2,2,0,2,0 3,2,0,2,2 2,2,0,2,0 2,2,0,2,0 2,2,0,2,0 1,2,0,3,0 1,2,0,3,0 1,2,0,3,0 2,2,0,2,0 2,2,0,2,0 2,2,0,2,0 2,2,0,2,0 2,2,0,2,0
2,2,0,2,0 2,2,0,2,0 2,2,0,2,0 2,2,0,2,0 2,2,0,2,0 1,2,0,3,0 1,2,0,3,0 1,2,0,3,0 2,2,0,2,0 2,2,0,2,0 2,2,0,2,0 2,2,0,2,0 2,2,0,2,0
1,2,0,3,0 1,2,0,3,0 1,2,0,3,0 1,2,0,3,0 1,2,0,3,0 1,2,0,3,0 1,2,0,3,0 1,2,0,3,0 1,2,0,3,0 1,2,0,3,0 1,2,0,3,0 1,2,0,3,0 1,2,0,3,0
1,2,0,3,0 1,2,0,3,0 1,2,0,3,0 1,2,0,3,0 1,2,0,3,0 1,2,0,3,0 1,2,0,3,0 1,2,0,3,0 1,2,0,3,0 1,2,0,3,0 1,2,0,3,0 1,2,0,3,0 1,2,0,3,0
2,2,0,2,0 2,2,0,2,0 2,2,0,2,0 2,2,0,2,0 2,2,0,2,0 1,2,0,3,0 1,2,0,3,0 1,2,0,3,0 5,N,1,2,1 2,2,0,2,0 2,2,0,2,0 2,2,0,2,0 2,2,0,2,0
2,2,0,2,0 3,2,0,2,2 2,2,0,2,0 2,2,0,2,0 2,2,0,2,0 1,2,0,3,0 1,2,0,3,0 1,2,0,3,0 2,2,0,2,0 2,2,0,2,0 2,2,0,2,0 2,2,0,2,0 2,2,0,2,0
2,2,0,2,0 2,2,0,2,0 2,2,0,2,0 3,2,0,2,2 2,2,0,2,0 1,2,0,3,0 1,2,0,3,0 1,2,0,3,0 2,2,0,2,0 2,2,0,2,0 2,2,0,2,0 2,2,0,2,0 2,2,0,2,0
2,2,0,2,0 2,2,0,2,0 2,2,0,2,0 2,2,0,2,0 2,2,0,2,0 1,2,0,3,0 1,2,0,3,0 1,2,0,3,0 2,2,0,2,0 3,2,0,2,2 2,2,0,2,0 2,2,0,2,0 2,2,0,2,0
2,2,0,2,0 2,2,0,2,0 2,2,0,2,0 2,2,0,2,0 2,2,0,2,0 1,2,0,3,0 1,2,0,3,0 1,2,0,3,0 2,2,0,2,0 2,2,0,2,0 2,2,0,2,0 3,2,0,2,2 2,2,0,2,0
2,2,0,2,0 2,2,0,2,0 3,2,0,2,2 2,2,0,2,0 2,2,0,2,0 1,2,0,3,0 1,2,0,3,0 1,2,0,3,0 2,2,0,2,0 2,2,0,2,0 2,2,0,2,0 2,2,0,2,0 2,2,0,2,0
2,2,0,2,0 2,2,0,2,0 2,2,0,2,0 2,2,0,2,0 2,2,0,2,0 1,2,0,3,0 1,2,0,3,0 1,2,0,3,0 2,2,0,2,0 2,2,0,2,0 2,2,0,2,0 2,2,0,2,0 2,2,0,2,0