2,2,0,2 2,2,0,2 2,2,0,2 2,2,0,2 2,2,0,2 1,2,0,3 1,2,0,3 1,2,0,3 2,2,0,2 2,2,0,2 4,N,2,4 2,2,0,2 2,2,0,2
2,2,0,2 3,2,0,2 2,2,0,2 2,2,0,2 2,2,0,2 1,2,0,3 6,N,3,3 1,2,0,3 2,2,0,2 2,2,0,2 4,N,2,4 2,2,0,2 2,2,0,2
2,2,0,2 2,2,0,2 2,2,0,2 2,2,0,2 2,2,0,2 1,2,0,3 1,2,0,3 1,2,0,3 2,2,0,2 2,2,0,2 4,N,2,4 2,2,0,2 3,2,0,2
2,2,0,2 2,2,0,2 3,2,0,2 2,2,0,2 2,2,0,2 1,2,0,3 1,2,0,3 1,2,0,3 2,2,0,2 2,2,0,2 4,N,2,4 2,2,0,2 2,2,0,2
2,2,0,2 2,2,0,2 2,2,0,2 2,2,0,2 2,2,0,2 1,2,0,3 1,2,0,3 1,2,0,3 2,2,0,2 2,2,0,2 4,N,4,4 4,N,2,4 4,N,2,4
2,2,0,2 3,2,0,2 2,2,0,2 2,2,0,2 2,2,0,2 1,2,0,3 1,2,0,3 1,2,0,3 2,2,0,2 2,2,0,2 2,2,0,2 2,2,0,2 2,2,0,2
2,2,0,2 2,2,0,2 2,2,0,2 2,2,0,2 2,2,0,2 1,2,0,3 1,2,0,3 1,2,0,3 2,2,0,2 2,2,0,2 2,2,0,2 2,2,0,2 2,2,0,2
1,2,0,3 1,2,0,3 1,2,0,3 1,2,0,3 1,2,0,3 1,2,0,3 1,2,0,3 1,2,0,3 1,2,0,3 1,2,0,3 1,2,0,3 1,2,0,3 1,2,0,3
1,2,0,3 1,2,0,3 1,2,0,3 1,2,0,3 1,2,0,3 1,2,0,3 1,2,0,3 1,2,0,3 1,2,0,3 1,2,0,3 1,2,0,3 1,2,0,3 1,2,0,3
2,2,0,2 2,2,0,2 2,2,0,2 2,2,0,2 2,2,0,2 1,2,0,3 1,2,0,3 1,2,0,3 5,N,1,2 2,2,0,2 2,2,0,2 2,2,0,2 2,2,0,2
2,2,0,2 3,2,0,2 2,2,0,2 2,2,0,2 2,2,0,2 1,2,0,3 1,2,0,3 1,2,0,3 2,2,0,2 2,2,0,2 2,2,0,2 2,2,0,2 2,2,0,2
2,2,0,2 2,2,0,2 2,2,0,2 3,2,0,2 2,2,0,2 1,2,0,3 1,2,0,3 1,2,0,3 2,2,0,2 2,2,0,2 2,2,0,2 2,2,0,2 2,2,0,2
2,2,0,2 2,2,0,2 2,2,0,2 2,2,0,2 2,2,0,2 1,2,0,3 1,2,0,3 1,2,0,3 2,2,0,2 3,2,0,2 2,2,0,2 2,2,0,2 2,2,0,2
2,2,0,2 2,2,0,2 2,2,0,2 2,2,0,2 2,2,0,2 1,2,0,3 1,2,0,3 1,2,0,3 2,2,0,2 2,2,0,2 2,2,0,2 3,2,0,2 2,2,0,2
2,2,0,2 2,2,0,2 3,2,0,2 2,2,0,2 2,2,0,2 1,2,0,3 1,2,0,3 1,2,0,3 2,2,0,2 2,2,0,2 2,2,0,2 2,2,0,2 2,2,0,2
2,2,0,2 2,2,0,2 2,2,0,2 2,2,0,2 2,2,0,2 1,2,0,3 1,2,0,3 1,2,0,3 2,2,0,2 2,2,0,2 2,2,0,2 2,2,0,2 2,2,0,2